#######
#@    #
#   ###
#   #
#   #
#  >#
#####
