#####
#@  #
#   #
#   #
#   #
#  >#
#####
